11111111111111111
10000C11000000001
11100000011001C01
10110111C00011001
1000000P0000000E1
11111111111111111
