111111111111111111111
1C0000000C00000001111
1011111111111110C0001
100000000000000001111
1C11110111110111C1111
1000000P0000000000001
1011111111111110C0011
1000000E0000000000111
1C00000000000000000C1
100000000000000000001
10111C0000001C1001001
111111111111111111111
