111111111111111
10000P00000C001
10C000000000011
1000000000000E1
111111111111111
