111111111111
1E00000000P1
110000000001
1C1000000001
111111111111
