11111111
1P0C0001
11001011
1C1000E1
11111111

