11111111
1P0C0001
10001011
1C0001E1
11111111

